In this first  step you will be required to extract a location from the user's description. This location will include a three-letter country code as well as a more specific descriptor, which is for rural scenarios a two/three letter city code (e.g. Muc) and for highways/major roads the road code (e.g. A9 or Lanker). The user may not provide you the country code explicitly, so you may have to deduce it with help of the following list:

ABW: Aruba
AFG: Afghanistan
AGO: Angola
AIA: Anguilla
ALA: Åland Islands
ALB: Albania
AND: Andorra
ARE: United Arab Emirates
ARG: Argentina
ARM: Armenia
ASM: American Samoa
ATA: Antarctica
ATF: French Southern Territories
ATG: Antigua and Barbuda
AUS: Australia
AUT: Austria
AZE: Azerbaijan
BDI: Burundi
BEL: Belgium
BEN: Benin
BES: Bonaire, Sint Eustatius and Saba
BFA: Burkina Faso
BGD: Bangladesh
BGR: Bulgaria
BHR: Bahrain
BHS: Bahamas
BIH: Bosnia and Herzegovina
BLM: Saint Barthélemy
BLR: Belarus
BLZ: Belize
BMU: Bermuda
BOL: Bolivia, Plurinational State of
BRA: Brazil
BRB: Barbados
BRN: Brunei Darussalam
BTN: Bhutan
BVT: Bouvet Island
BWA: Botswana
CAF: Central African Republic
CAN: Canada
CCK: Cocos (Keeling) Islands
CHE: Switzerland
CHL: Chile
CHN: China
CIV: Côte d'Ivoire
CMR: Cameroon
COD: Congo, The Democratic Republic of the
COG: Congo
COK: Cook Islands
COL: Colombia
COM: Comoros
CPV: Cabo Verde
CRI: Costa Rica
CUB: Cuba
CUW: Curaçao
CXR: Christmas Island
CYM: Cayman Islands
CYP: Cyprus
CZE: Czechia
DEU: Germany
DJI: Djibouti
DMA: Dominica
DNK: Denmark
DOM: Dominican Republic
DZA: Algeria
ECU: Ecuador
EGY: Egypt
ERI: Eritrea
ESH: Western Sahara
ESP: Spain
EST: Estonia
ETH: Ethiopia
FIN: Finland
FJI: Fiji
FLK: Falkland Islands (Malvinas)
FRA: France
FRO: Faroe Islands
FSM: Micronesia, Federated States of
GAB: Gabon
GBR: United Kingdom
GEO: Georgia
GGY: Guernsey
GHA: Ghana
GIB: Gibraltar
GIN: Guinea
GLP: Guadeloupe
GMB: Gambia
GNB: Guinea-Bissau
GNQ: Equatorial Guinea
GRC: Greece
GRD: Grenada
GRL: Greenland
GTM: Guatemala
GUF: French Guiana
GUM: Guam
GUY: Guyana
HKG: Hong Kong
HMD: Heard Island and McDonald Islands
HND: Honduras
HRV: Croatia
HTI: Haiti
HUN: Hungary
IDN: Indonesia
IMN: Isle of Man
IND: India
IOT: British Indian Ocean Territory
IRL: Ireland
IRN: Iran, Islamic Republic of
IRQ: Iraq
ISL: Iceland
ISR: Israel
ITA: Italy
JAM: Jamaica
JEY: Jersey
JOR: Jordan
JPN: Japan
KAZ: Kazakhstan
KEN: Kenya
KGZ: Kyrgyzstan
KHM: Cambodia
KIR: Kiribati
KNA: Saint Kitts and Nevis
KOR: Korea, Republic of
KWT: Kuwait
LAO: Lao People's Democratic Republic
LBN: Lebanon
LBR: Liberia
LBY: Libya
LCA: Saint Lucia
LIE: Liechtenstein
LKA: Sri Lanka
LSO: Lesotho
LTU: Lithuania
LUX: Luxembourg
LVA: Latvia
MAC: Macao
MAF: Saint Martin (French part)
MAR: Morocco
MCO: Monaco
MDA: Moldova, Republic of
MDG: Madagascar
MDV: Maldives
MEX: Mexico
MHL: Marshall Islands
MKD: North Macedonia
MLI: Mali
MLT: Malta
MMR: Myanmar
MNE: Montenegro
MNG: Mongolia
MNP: Northern Mariana Islands
MOZ: Mozambique
MRT: Mauritania
MSR: Montserrat
MTQ: Martinique
MUS: Mauritius
MWI: Malawi
MYS: Malaysia
MYT: Mayotte
NAM: Namibia
NCL: New Caledonia
NER: Niger
NFK: Norfolk Island
NGA: Nigeria
NIC: Nicaragua
NIU: Niue
NLD: Netherlands
NOR: Norway
NPL: Nepal
NRU: Nauru
NZL: New Zealand
OMN: Oman
PAK: Pakistan
PAN: Panama
PCN: Pitcairn
PER: Peru
PHL: Philippines
PLW: Palau
PNG: Papua New Guinea
POL: Poland
PRI: Puerto Rico
PRK: Korea, Democratic People's Republic of
PRT: Portugal
PRY: Paraguay
PSE: Palestine, State of
PYF: French Polynesia
QAT: Qatar
REU: Réunion
ROU: Romania
RUS: Russian Federation
RWA: Rwanda
SAU: Saudi Arabia
SDN: Sudan
SEN: Senegal
SGP: Singapore
SGS: South Georgia and the South Sandwich Islands
SHN: Saint Helena, Ascension and Tristan da Cunha
SJM: Svalbard and Jan Mayen
SLB: Solomon Islands
SLE: Sierra Leone
SLV: El Salvador
SMR: San Marino
SOM: Somalia
SPM: Saint Pierre and Miquelon
SRB: Serbia
SSD: South Sudan
STP: Sao Tome and Principe
SUR: Suriname
SVK: Slovakia
SVN: Slovenia
SWE: Sweden
SWZ: Eswatini
SXM: Sint Maarten (Dutch part)
SYC: Seychelles
SYR: Syrian Arab Republic
TCA: Turks and Caicos Islands
TCD: Chad
TGO: Togo
THA: Thailand
TJK: Tajikistan
TKL: Tokelau
TKM: Turkmenistan
TLS: Timor-Leste
TON: Tonga
TTO: Trinidad and Tobago
TUN: Tunisia
TUR: Turkey
TUV: Tuvalu
TWN: Taiwan, Province of China
TZA: Tanzania, United Republic of
UGA: Uganda
UKR: Ukraine
UMI: United States Minor Outlying Islands
URY: Uruguay
USA: United States
UZB: Uzbekistan
VAT: Holy See (Vatican City State)
VCT: Saint Vincent and the Grenadines
VEN: Venezuela, Bolivarian Republic of
VGB: Virgin Islands, British
VIR: Virgin Islands, U.S.
VNM: Viet Nam
VUT: Vanuatu
WLF: Wallis and Futuna
WSM: Samoa
YEM: Yemen
ZAF: South Africa
ZAM: This is a special country code used for artificial road networks that were designed by hand. If a user requests such a road network, return ZAM as the country code.
ZMB: Zambia
ZWE: Zimbabwe

The second part of the location has to be specified explicitly by the user, i.e. a city or road code must be supplied. Otherwise, exclude that field. Also, if a user only specifies one of the fields, exclude the other one. If neither fields are specified, exclude them both. Return your answer in the following JSON format:

{
  "country_code": XXX,
  "specifier": string
}

country_code is the three-letter country code and "specifier" the additional information.  Only ever return one country_code value, never more than that. To aid you in the process, have a look at the following list of examples:

User input: The scenario takes place in Munich in Germany; the city code is Muc.
Output:
{
  "country_code": "DEU",
  "specifier": "Muc"
}
Reasoning: The user specified Germany as a country, for which the code is DEU. He gave Muc as a clearly defined city code, so that fills up the specifier field.

User input: In Belgium. The city is Geneva.
Output:
{
  "country_code": "BEL"
}
Reasoning: The user specified Belgium as a country, but only gave the name of a city, not an actual code. This cannot be processed and therefore we remove the specifier field.

User input: The location does not matter to me.
Output:
{
}
Reasoning: The user gave us no information, so we exclude both fields and return an empty JSON object.

User input: The network should be artificial.
Output:
{
  "country_code": "ZAM"
}
Reasoning: The user did not specify a city/road code, so we exclude that field. However, he has specified that the network should be artificial, which is why we use "ZAM" as a country code.